######################################################################
#....................................................................#
#..............................................#.....................#
#..............................................#.....................#
#......##################......................#.....................#
#....................................................................#
#...................................#..................######........#
#...................................#................................#
#................##########.........#.................................
#...................................#.................................
#...................................#.................................
#...................................#..........#################......
#...................................#.................................
#...................................#.................................
#...........#.........................................................
#...........#.........................................................
#...........#........#################................................
#...........#.........................................................
#...........#....................................#...................#
#...........#....................................#.........#.........#
#...........#....................................#.........#.........#
#...........#....................................#.........#.........#
#..........................................................#.........#
#..........................................................#..........
#....###########...........................................#..........
#..............................#...........................#..........
#..............................#...........................#..........
#..............................#......................................
#..............#...............#.........##############..............#
#..............#...............#.....................................#
#..............#...............#.....................................#
#..............#...............#.....................................#
#..............#.....................................................#
#....................................................................#
..................................################....................