######################################################################
#....................................................................#
#....................................................................#
#........................................................#...........#
#.................#############..........................#...........#
#.........................##############.................#...........#
#.........#..............................................#...........#
#.........#..............................................#...........#
#.........#..............................................#...........#
#.........#..............................................#...........#
#.........#..........................................................#
#.........#..........................................................#
#.........#..........................................................#
#....................................................................#
#..............................................###########...........#
#.........#..........................................................#
#.........#.............................#.............................
#.........#.............................#.............................
#.........#.............................#.............................
#.........#.............................#.............................
#.........#.............................#............................#
#.........#.............................#............................#
#....................................................................#
#....................................................................#
#.................................###############....................#
#....................................................................#
#....................................................................#
#................................#...................................#
#................................#...................................#
#..............#########.........#...................................#
#................................#...................................#
#................................#...................................#
#................................#...................................#
#....................................................................#
######################################################################