######################################################################
#....................................................................#
#............................................#.......................#
#...........###############..................#.......................#
#............................................#.......................#
#............................................#.......................#
#...................................#........#.......................#
#.........#.........................#........#.......................#
#.........#.........................#........#..........#####........#
#.........#.........................#........#.......................#
#.........#....########.............#................................#
#.........#.........................#................................#
#.........#.........................#................................#
#.........#.........................#................................#
#.........#.........................##############...................#
#.........#..........................................................#
#.........#..........................................................#
#.........#..............##############.............#................#
#...................................................#................#
#...................................................#................#
#.....##############................................#................#
#.............#.....................................#................#
#.............#......................................................#
#.............#......................................................#
#.............#..............................##################......#
#.............#......................................................#
#.............#................#.....................................#
#.............#................#.....................................#
#.............#................#...........................#.........#
#..............................#...........................#.........#
#..............................#...........................#.........#
#..............................#...........................#.........#
#..........................................................#.........#
#....................................................................#
######################################################################